XXXXXXXXXXXXX
x--bxxxxxxxxx
x-XXx-bx---xx
x-b-x-Xx-bbxx
xXX-x-xx-XXxx
x--bx-xx-xb-x
x-XXx-x--xX-x
x---x-x--xx-x
xXX-x-x--xx-x
xxx---------x
xxxXXXXXXXXXx
xxxxxxxxxxxxx
xxxxxxxxxxxxx